10 10
1 2 3 4 1 2 3 4 1 2 
3 4 1 2 3 4 1 2 3 4 
1 2 3 4 1 2 3 4 1 2 
3 4 1 2 3 4 1 2 3 4 
5 1 2 3 4 5 1 5 2 3 
5 4 1 2 3 5 4 1 2 3 
5 4 1 5 2 3 4 5 1 2 
3 4 5 1 2 3 4 5 0 0 
0 0 0 0 0 0 0 0 0 0 
0 0 0 0 0 0 0 0 0 0 
