10 10
2 3 4 1 2 3 4 1 2 3 
4 1 2 3 4 1 2 3 4 1 
2 3 1 2 3 4 1 2 3 4 
1 2 3 4 1 2 3 4 1 2 
3 4 1 2 3 4 1 2 3 4 
1 2 3 4 1 2 3 4 1 2 
3 4 1 2 3 4 4 4 4 4 
4 3 1 2 3 4 1 2 3 4 
1 2 3 1 2 3 2 3 4 1 
2 3 4 1 3 2 3 3 4 4 
